########################################
##       ####          ##             ##
#   MMMMM       ####  ####     #      ##
##       ####    #             #      ##
##########      ################ #######
##        ###   #       #   #  #     ###
##     #        ##          ##  #     ##
##     #  ###            #            ##
## ###    ###   # #    ##   # #      ###
###   #######   # #     #   #     #   ##
##  #       # # #           # #       ##
## #   ###### # ########################
#      #      #       #   #      ##   ##
###    ##  ########  #       #        ##
##          ###   #                  ###
##   #                               ###
#             #   ######################
###           #                    # ###
##         #  #         ]          [E ##
##   #        #                    # ###
########################################