##############     ##################    ###################  ##########     ## 
##      #                                                              #        
##      #                                                              #        
##         #         ######## ########## ########## #################  #        
##      #  #         ####         ##         ##         #############           
##      #  #         ####         ##         ##         #############  #       #
#########  ########  ####         ##         ##         #############  #    ####
#########  ########  ################################################  #########
##      #  ########  ################################################  #      ##
##      #  ########  ################################################  #      ##
##         ##   ###  ################################################         ##
##      #####        ################################################  #      ##
##          #   #####################################################  #      ##
 ######### ### #################################################################
   ######   #   #                            ###################################
            #                        ###################################        
                                        ##########################              
        #   #                        #########################                  
        #   ##############################################                      
         ################################           #######      bgcrmy-_BGCRMYW