########################################
########################################
########################################
########################################
########################################
########################################
########################################
########################################
###B       #  B    #B#    B  #      B###
##B        B                 B       B##
## H B B   B     B#B#B#B     BC K#  3D E
##B        B                 B       B##
###B       #  B    #B#    B  #      B###
########################################
########################################
########################################
########################################
########################################
########################################
########################################
########################################