#####E##################################
##                                    ##
##                                    ##
##                                    ##
##                                    ##
##                                    ##
##                                    ##
##                                    ##
##                                    ##
##                                    ##
##                                    ##
##                                    ##
##                                    ##
##                                    ##
##             H                      ##
##                                    ##
##                                    ##
##                                    ##
##                                    ##
##                                    ##
########################################