Здесь приведены обозначения символов для построения карт и их задних фонов с примерами.
По задумке все объекты на уровне используют светлые цвета, а фон тёмные (кроме ящика - он коричневый (тёмно-жёлтый)).
----------------------------------------------------
                      Объекты
' ': - пустота
'H': - герой
'#': - стена
'd': - дверь
'D': - дверь уровня
'k': - ключ
'K': - ключ от двери уровня
'b': - ящик
'E': - выход с уровня
'c': - кристал
'm': - мина
'F': - туман войны
'3': - жизнь
's': - скелет
'r': - камень

----------------------------------------------------
                   Пример уровня
				   
	########################################
	######################D#################
	#######################D################
	##############DDDDDDDDDDD###############
	#######################D################
	######################D#################
	########################################
	########################################
	########################################
	######   M C M   #M C    BM       ###D##
	#### H   #####C  B  M#   C  ]#C   C [ED#
	######      BC  ##   C   BM       ###D##
	########################################
	########################################
	########################################
	######################D#################
	#######################D################
	##############DDDDDDDDDDD###############
	#######################D################
	######################D#################
	########################################

----------------------------------------------------
                     Задний фон
# или ' ' = Чёрный
b = Тёмно-синий
g = Тёмно-зелёный
c = Голубой
r = Тёмно-красный
m = Фиолетовый
y = Тёмно-жёлтый (+-коричневый)
- = Серый
_ = Тёмно-серый
B = Синий
G = Зелёный
C = Бирюзовый
R = Красный
M = Фиолетовый
Y = Жёлтый
W = Белый

----------------------------------------------------
             Пример заднего фона для уровня

	########################################
	#                                      #
	#                                      #
	#                                      #
	#                                      #
	#                                      #
	#                                      #
	#                                      #
	########################################
	######           #  C       CCC  W###M##
	#### SССС#####CCCCCCC#CCCCCCC#CCWWWWWMM#
	######  CCCCCCC  ## CCC          W###M##
	########################################
	#                                      #
	#                                      #
	#                                      #
	#                                      #
	#                                      #
	#                                      #
	#                                      #
	########################################